.................
.................
.................
.................
.................
.................
...OOOOO.........
OOOO.............
O................
O................
O................
.................
..............X..
.................
.................
